15
oo..o......oo...o...
o.o.oo.o........o.o.
..o.o.o.oo..o.o.....
.o.o.......o...o....
o..oo.o.o..oo.......
...oo...o...o..o...o
...oo.o.......o.....
..o..oooo......o....
.o.....o.oooo.oo.o..
.o..o...o...o.......
.......o...o..o.....
o..o.....oo.....o...
o.o..o.ooo.oo..ooo..
..oo.o.....o..o.....
..........oo.o......